11111111111111111111111111111111
10000000000000000000000000000001
10000000000000000000000000000001
10000000000000000000000000000001
10000100000000000000000000000001
10000100000000000000000000000001
10000100000000000000000000000001
10000100000000000000000000000001
10000100000000000000000000000001
10000100000000000000000000000001
10000111111110000000000000000001
10000000000010000000000000000001
10000000000010000000000000000001
10000000000010000000000000000001
10000000000010000000000000000001
10000000000010000000000000000001
10000000000000000000000000001111
10000000000010000000000000000001
10001111111110000000111110000001
10000000000000000000000000000001
10000000000000111000000000000001
10000000000000000000000000000001
100P0001111000000000000000000001
11111111111111111111111111111111